2 2 2 2 2 2 2 2 2 2 2 2 2 2 2 2 2 2 2 2 2 2 2 2 2 2 2 2 2 2 2 2 2 2 2 2 2 2 2 2 2 2 2 2 2 2 2 2 2 2
2 1 1 1 1 1 1 1 1 1 1 1 1 1 1 1 1 1 1 1 1 1 1 1 1 1 1 1 1 1 1 1 1 1 1 1 1 1 1 1 2 2 2 2 2 2 2 2 1 2
2 1 0 0 0 0 0 0 0 0 0 0 0 0 0 0 4 4 1 1 1 3 3 3 0 0 0 0 0 0 0 0 0 0 0 0 4 4 1 2 2 1 2 3 3 1 1 1 1 2 
2 1 0 0 0 0 4 4 1 1 1 1 2 3 3 3 0 0 0 0 0 0 0 0 0 0 4 4 1 3 3 3 3 3 3 3 3 3 2 2 1 0 0 0 0 0 0 4 1 2
2 1 1 2 2 2 2 3 3 0 0 0 0 0 0 0 0 4 4 1 1 1 1 1 2 2 2 2 3 3 0 0 0 1 1 1 1 1 4 4 1 1 1 1 1 2 2 2 1 2
2 1 0 0 0 0 0 0 0 4 4 1 1 1 1 1 2 2 2 2 3 3 0 0 0 0 0 0 0 0 4 4 1 1 1 1 1 0 0 0 0 0 0 0 0 0 0 0 1 2
2 1 0 0 0 0 0 0 0 0 0 0 0 0 0 0 4 4 1 1 2 2 2 2 2 2 2 2 2 0 0 0 0 0 0 0 0 0 0 0 0 0 0 0 0 4 4 1 1 2
2 1 0 0 0 0 0 0 0 0 0 0 0 0 0 0 4 4 1 1 2 2 2 2 2 2 2 2 2 0 0 0 0 0 0 0 0 0 0 0 0 0 0 0 0 4 4 1 1 2
2 1 0 0 0 0 0 0 0 0 0 0 0 0 0 0 4 4 1 1 2 2 2 2 2 2 2 2 2 0 0 0 0 0 0 0 0 0 0 0 0 0 0 0 0 4 4 1 1 2
2 1 0 0 0 0 0 0 0 0 0 0 0 0 0 0 4 4 1 1 2 2 2 2 2 2 2 2 2 0 0 0 0 0 0 0 0 0 0 0 0 0 0 0 0 4 4 1 1 2
2 1 0 0 0 0 0 0 0 0 0 0 0 0 0 0 4 4 1 1 2 2 2 2 2 2 2 2 2 0 0 0 0 0 0 0 0 0 0 0 0 0 0 0 0 4 4 1 1 2
2 2 2 2 2 2 2 2 2 2 2 2 2 2 2 2 2 2 2 2 2 2 2 2 2 2 2 2 2 2 2 2 2 2 2 2 2 0 2 2 2 2 2 2 2 2 2 2 2 2
2 2 2 2 2 2 2 2 2 2 2 2 2 2 2 2 2 2 2 2 2 2 2 2 2 2 2 2 2 2 2 2 2 2 2 2 2 0 2 2 2 2 2 2 2 2 2 2 2 2
2 1 0 0 0 0 0 0 0 0 0 0 0 0 0 0 4 4 1 1 2 2 2 2 2 2 2 2 2 0 0 0 0 0 0 0 0 0 0 0 0 0 0 0 0 4 4 1 1 2
2 1 0 0 0 0 0 0 0 0 0 0 0 0 0 0 4 4 1 1 2 2 2 2 2 2 2 2 2 0 0 0 0 0 0 0 0 0 0 0 0 0 0 0 0 4 4 1 1 2
2 1 0 0 0 0 0 0 0 0 0 0 0 0 0 0 4 4 1 1 2 2 2 2 2 2 2 2 2 0 0 0 0 0 0 0 0 0 0 0 0 0 0 0 0 4 4 1 1 2
2 1 0 0 0 0 0 0 0 0 0 0 0 0 0 0 4 4 1 1 2 2 2 2 2 2 2 2 2 0 0 0 0 0 0 0 0 0 0 0 0 0 0 0 0 4 4 1 1 2
2 1 0 0 0 0 0 0 0 0 0 0 0 0 0 0 4 4 1 1 2 2 2 2 2 2 2 2 2 0 0 0 0 0 0 0 0 0 0 0 0 0 0 0 0 4 4 1 1 2
2 1 0 0 0 0 0 0 0 0 0 0 0 0 0 0 4 4 1 1 2 2 2 2 2 2 2 2 2 0 0 0 0 0 0 0 0 0 0 0 0 0 0 0 0 4 4 1 1 2
2 1 0 0 0 0 0 0 0 0 0 0 0 0 0 0 4 4 1 1 2 2 2 2 2 2 2 2 2 0 0 0 0 0 0 0 0 0 0 0 0 0 0 0 0 4 4 1 1 2
2 1 0 0 0 0 0 0 0 0 0 0 0 0 0 0 1 1 1 1 1 1 1 1 1 1 1 1 1 0 0 0 0 0 0 0 0 0 0 0 0 0 0 0 0 4 4 1 1 2
2 1 0 0 0 0 0 0 0 0 0 0 0 0 0 0 4 4 1 1 2 2 2 2 2 2 2 2 2 0 0 0 0 0 0 0 0 0 0 0 0 0 0 0 0 4 4 1 1 2
2 1 0 0 0 0 0 0 0 0 0 0 0 0 0 0 4 4 1 1 2 2 2 2 2 2 2 2 2 0 0 0 0 0 0 0 0 0 0 0 0 0 0 0 0 4 4 1 1 2
2 1 0 0 0 0 0 0 0 0 0 0 0 0 0 0 4 4 1 1 2 2 2 2 2 2 2 2 2 0 0 0 0 0 0 0 0 0 0 0 0 0 0 0 0 4 4 1 1 2
2 1 0 0 0 0 0 0 0 0 0 0 0 0 0 0 4 4 1 1 2 2 2 2 2 2 2 2 2 0 0 0 0 0 0 0 0 0 0 0 0 0 0 0 0 4 4 1 1 2
2 1 0 0 0 0 0 0 0 0 0 0 0 0 0 0 4 4 1 1 2 2 2 2 2 2 2 2 2 0 0 0 0 0 0 0 0 0 0 0 0 0 0 0 0 4 4 1 1 2
2 1 0 0 0 0 0 0 0 0 0 0 0 0 0 0 4 4 1 1 2 2 2 2 2 2 2 2 2 0 0 0 0 0 0 0 0 0 0 0 0 0 0 0 0 4 4 1 1 2
2 1 0 0 0 0 0 0 0 0 0 0 0 0 0 0 4 4 1 1 2 2 2 2 2 2 2 2 2 0 0 0 0 0 0 0 0 0 0 0 0 0 0 0 0 4 4 1 1 2
2 1 0 0 0 0 0 0 0 0 0 0 0 0 0 0 4 4 1 1 2 2 2 2 2 2 2 2 2 0 0 0 0 0 0 0 0 0 0 0 0 0 0 0 0 4 4 1 1 2
2 1 0 0 0 0 0 0 0 0 0 0 0 0 0 0 4 4 1 1 2 2 2 2 2 2 2 2 2 0 0 0 0 0 0 0 0 0 0 0 0 0 0 0 0 4 4 1 1 2
2 1 0 0 0 0 0 0 0 0 0 0 0 0 0 0 4 4 1 1 2 2 2 2 2 2 2 2 2 0 0 0 0 0 0 0 0 0 0 0 0 0 0 0 0 4 4 1 1 2
2 1 0 0 0 0 0 0 0 0 0 0 0 0 0 0 4 4 1 1 2 2 2 2 2 2 2 2 2 0 0 0 0 0 0 0 0 0 0 0 0 0 0 0 0 4 4 1 1 2
2 1 0 0 0 0 0 0 0 0 0 0 0 0 0 0 4 4 1 1 2 2 2 2 2 2 2 2 2 0 0 0 0 0 0 0 0 0 0 0 0 0 0 0 0 4 4 1 1 2
2 1 0 0 0 0 0 0 0 0 0 0 0 0 0 0 4 4 1 1 2 2 2 2 2 2 2 2 2 0 0 0 0 0 0 0 0 0 0 0 0 0 0 0 0 4 4 1 1 2
2 1 0 0 0 0 0 0 0 0 0 0 0 0 0 0 4 4 1 1 2 2 2 2 2 2 2 2 2 0 0 0 0 0 0 0 0 0 0 0 0 0 0 0 0 4 4 1 1 2
2 1 0 0 0 0 0 0 0 0 0 0 0 0 0 0 4 4 1 1 2 2 2 2 2 2 2 2 2 0 0 0 0 0 0 0 0 0 0 0 0 0 0 0 0 4 4 1 1 2
2 1 0 0 0 0 0 0 0 0 0 0 0 0 0 0 4 4 1 1 2 2 2 2 2 2 2 2 2 0 0 0 0 0 0 0 0 0 0 0 0 0 0 0 0 4 4 1 1 2
2 1 0 0 0 0 0 0 0 0 0 0 0 0 0 0 4 4 1 1 2 2 2 2 2 2 2 2 2 0 0 0 0 0 0 0 0 0 0 0 0 0 0 0 0 4 9 1 1 2
2 1 0 0 0 0 0 0 0 0 0 1 0 0 0 0 4 4 1 1 2 2 2 2 2 2 2 2 2 0 0 0 0 0 0 0 0 0 0 0 0 9 9 9 9 9 9 9 9 9
2 1 0 0 0 0 0 0 0 1 1 1 1 0 0 0 4 4 1 1 2 2 2 2 2 2 2 2 2 0 0 0 0 0 0 0 0 0 0 0 0 9 0 0 0 0 0 0 4 9
2 2 2 2 2 2 2 2 2 1 1 1 2 2 2 2 2 2 2 2 2 2 2 2 2 2 2 2 2 2 2 2 2 2 2 2 2 2 2 2 2 2 2 2 2 9 9 9 9 9
2 2 2 2 2 2 2 2 2 4 4 2 2 2 2 2 2 2 2 2 2 2 2 2 2 2 2 2 2 2 2 2 2 2 2 2 2 2 2 2 2 2 2 2 2 9 9 2 2 2
2 4 0 0 0 0 0 0 4 4 4 0 0 0 0 0 9 9 9 9 9 9 9 9 9 9 9 9 9 9 9 4 4 4 4 4 4 4 4 4 4 4 4 4 4 4 9 4 4 2
2 4 0 0 0 0 0 0 0 4 0 0 0 0 0 0 4 4 4 4 3 3 3 3 3 3 3 3 3 4 4 4 4 4 4 4 4 4 4 4 4 4 4 4 4 4 9 4 4 2
9 4 0 0 0 0 0 0 0 0 0 0 0 0 0 0 4 4 4 4 3 3 3 3 3 3 3 3 3 4 4 4 4 4 4 4 4 4 4 4 4 4 4 4 4 4 9 4 4 9
3 4 0 0 0 0 0 0 0 0 0 0 0 0 0 0 4 4 4 4 3 3 3 3 3 3 3 3 3 4 4 4 4 4 4 4 4 4 4 4 4 4 4 4 4 4 4 4 4 3
3 4 0 0 0 0 0 0 0 0 0 0 0 0 0 0 4 4 4 4 4 4 4 4 4 4 4 4 4 4 4 4 4 4 4 4 4 4 4 4 4 4 4 4 4 4 4 4 3 3
3 4 0 0 0 0 0 0 0 0 0 0 0 0 0 0 4 4 4 4 3 3 3 3 3 3 3 3 3 4 4 4 4 4 4 4 4 4 4 4 4 4 4 4 4 4 4 4 4 3
3 4 4 4 4 4 4 4 4 4 4 4 4 4 4 4 4 4 4 4 3 3 3 3 3 3 3 3 3 4 4 4 4 4 4 4 4 4 4 4 4 4 4 4 4 4 4 4 4 3
3 3 3 3 3 3 3 3 3 3 3 3 3 3 3 3 3 3 3 3 3 3 3 3 3 3 3 3 3 3 3 3 3 3 3 3 3 3 3 3 3 3 3 3 3 3 3 3 3 3

